AnionEM = ( Ca2_c AND ( ( ( NOT ABI1 ) )  OR ( ( pH ) ) )    )  OR ( pH AND ( ( ( Ca2_c ) )  OR ( ( NOT ABI1 ) ) )    ) 
ROP2 = ( PA ) 
ABI1 = ( ( ( pH  ) AND NOT ( ROS  )  ) AND NOT ( PA  ) ) 
OST1 = ( ABA ) 
Malate = ( ( ( PEPC  ) AND NOT ( ABA  )  ) AND NOT ( AnionEM  ) ) 
PEPC =  NOT ( ( ABA ) )
cADPR = ( ADPRc ) 
CaIM = ( ( ( ABH1 AND ( ( ( NOT ERA1 ) ) )     ) AND NOT ( Depolar  ) )  OR ( ( ROS  ) AND NOT ( Depolar  ) )  OR ( ( ERA1 AND ( ( ( NOT ABH1 ) ) )     ) AND NOT ( Depolar  ) )  ) OR  NOT ( ABH1 OR Depolar OR ERA1 OR ROS ) 
KOUT = ( ( Depolar  ) AND NOT ( ROS AND ( ( ( NO ) ) )     ) )  OR ( pH AND ( ( ( Depolar ) ) )    ) 
RAC1 =  NOT ( ( ABA )  OR ( ABI1 ) )
ADPRc = ( NO ) 
SphK = ( ABA ) 
PLC = ( ABA AND ( ( ( Ca2_c ) ) )    ) 
Actin = ( ( Ca2_c )  ) OR  NOT ( Ca2_c OR RAC1 ) 
PA = ( PLD ) 
KEV = ( Ca2_c ) 
NO = ( NOS AND ( ( ( NIA12 ) ) )    ) 
Atrboh = ( ( OST1 AND ( ( ( ROP2  AND pH ) ) )     ) AND NOT ( ABI1  ) ) 
NOS = ( Ca2_c ) 
Depolar = ( ( AnionEM )  OR ( KEV )  OR ( KOUT AND ( ( ( ( NOT Ca2_c ) AND ( NOT HTPase ) AND ( NOT KEV ) AND ( NOT AnionEM ) ) ) )    )  OR ( Ca2_c )  OR ( HTPase AND ( ( ( ( NOT Ca2_c ) AND ( NOT KEV ) AND ( NOT AnionEM ) AND ( NOT KOUT ) ) ) )    )  ) OR  NOT ( Ca2_c OR HTPase OR KEV OR AnionEM OR KOUT ) 
CIS = ( InsP3 AND ( ( ( InsP6 ) ) )    )  OR ( cGMP AND ( ( ( cADPR ) ) )    ) 
Ca2_c = ( ( CIS  ) AND ( NOT ( Ca2_ATPase  ) ) )  OR ( ( CaIM  ) AND ( NOT ( Ca2_ATPase  ) ) ) 
InsP6 = ( InsPK ) 
ROP10 = ( ERA1 ) 
AGB1 = ( GPA1 ) 
RCN1 = ( ABA ) 
KAP = ( ( Depolar  ) AND NOT ( Ca2_c AND ( ( ( pH ) ) )     ) ) 
cGMP = ( GC ) 
GPA1 = ( ( AGB1  ) AND NOT ( GCR1  ) )  OR ( S1P AND ( ( ( AGB1 ) ) )    ) 
InsPK = ( ABA ) 
InsP3 = ( PLC ) 
pH = ( ABA ) 
GC = ( NO ) 
PLD = ( GPA1 ) 
HTPase =  NOT ( ( ROS )  OR ( pH )  OR ( Ca2_c ) )
NIA12 = ( RCN1 ) 
S1P = ( SphK ) 
Ca2_ATPase = ( Ca2_c ) 
ROS = ( Atrboh ) 
Closure = ( ( KAP AND ( ( ( Actin ) )  AND ( ( AnionEM ) ) )     ) AND NOT ( Malate  ) )  OR ( ( KOUT AND ( ( ( AnionEM ) )  AND ( ( Actin ) ) )     ) AND NOT ( Malate  ) ) 
